8 8 2 45
#  #####
#   @  #
D +  ! #
# #    #
#   +   
  /  @ +
D  +   #
#@@  ###