10 10 3 50
##+##  ###
  /   @   
#   D    #
#     D  #
+  D   ++#
   #  #  #
 +   @   #
#     ++ #
#   @  ! #
###   ####